adren|alina	adrena
bater|ista	batera
berm|uda	bermas
bob|eira	bobis
burocr|ata	burocra
cerv|eja	cerva
deleg|ado	delega
flagr|ante	flagra
forast|eira	forasta
fort|una	furta
neur|ose	neura
pij|ama	pija
portug|uês	portuga
prolet|ário 	proleta
refri|gerante	refri
salafrá|rio	salafra
sapat|ão	sapata
saudad|es	saudas
secret|ária 	secreta
trav|esti	trava
vagab|unda	vagaba
vestib|ular	vestiba
